99999999999999999999999999999999
99999999999999999999999999999999
99999999999999999999999999999999
99911111111111111111111111111999
99910205010000010000000000001999
99910000010000000000000010401999
99910000010000011111060011111999
99910000000111010000000000001999
99910000000000010111000000001999
99911111060111110000001000001999
99910401000000000000001000001999
99910000000000010000001050021999
99911111111111111111111111111999
99999999999999999999999999999999
99999999999999999999999999999999
99999999999999999999999999999999